"filename", "language", "TypeScript React", "SCSS", "comment", "blank", "total"
"/Users/julianklummer/WebProjects/synergic/src/app/App.tsx", "TypeScript React", 12, 0, 0, 2, 14
"/Users/julianklummer/WebProjects/synergic/src/app/AppProvider.tsx", "TypeScript React", 13, 0, 0, 2, 15
"/Users/julianklummer/WebProjects/synergic/src/app/components/PageBrowser/PageBrowser.tsx", "TypeScript React", 83, 0, 0, 11, 94
"/Users/julianklummer/WebProjects/synergic/src/app/components/PageBrowser/PageBrowserItem/PageBrowserItem.tsx", "TypeScript React", 55, 0, 0, 6, 61
"/Users/julianklummer/WebProjects/synergic/src/app/components/PagePreview/PagePreview.tsx", "TypeScript React", 14, 0, 0, 4, 18
"/Users/julianklummer/WebProjects/synergic/src/app/components/TemplateBrowser/TemplateBrowser.tsx", "TypeScript React", 84, 0, 0, 11, 95
"/Users/julianklummer/WebProjects/synergic/src/app/components/TemplateBrowser/TemplateBrowserItem/TemplateBrowserItem.tsx", "TypeScript React", 55, 0, 0, 6, 61
"/Users/julianklummer/WebProjects/synergic/src/app/components/atoms/AddComponent/AddComponent.tsx", "TypeScript React", 74, 0, 0, 4, 78
"/Users/julianklummer/WebProjects/synergic/src/app/components/atoms/AddTemplate/AddTemplate.tsx", "TypeScript React", 76, 0, 0, 4, 80
"/Users/julianklummer/WebProjects/synergic/src/app/components/atoms/LoadingBackdrop/LoadingBackdrop.tsx", "TypeScript React", 15, 0, 0, 2, 17
"/Users/julianklummer/WebProjects/synergic/src/app/components/builderComponents/atomPreview/AtomPreview.tsx", "TypeScript React", 18, 0, 0, 4, 22
"/Users/julianklummer/WebProjects/synergic/src/app/components/builderComponents/moleculesPreview/MoleculePreview.tsx", "TypeScript React", 55, 0, 2, 6, 63
"/Users/julianklummer/WebProjects/synergic/src/app/components/builderComponents/organismPreview/OrganismPreview.tsx", "TypeScript React", 80, 0, 2, 6, 88
"/Users/julianklummer/WebProjects/synergic/src/app/components/componentBrowser/ComponentBrowser.tsx", "TypeScript React", 80, 0, 0, 9, 89
"/Users/julianklummer/WebProjects/synergic/src/app/components/componentBrowser/componentList/AtomList/AtomList.tsx", "TypeScript React", 27, 0, 0, 4, 31
"/Users/julianklummer/WebProjects/synergic/src/app/components/componentBrowser/componentList/BrowserItem/BrowserItem.tsx", "TypeScript React", 85, 0, 0, 7, 92
"/Users/julianklummer/WebProjects/synergic/src/app/components/componentBrowser/componentList/BuilderComponentList/BuilderComponentList.tsx", "TypeScript React", 104, 0, 0, 12, 116
"/Users/julianklummer/WebProjects/synergic/src/app/components/componentBrowser/componentList/ComponentList.tsx", "TypeScript React", 113, 0, 0, 12, 125
"/Users/julianklummer/WebProjects/synergic/src/app/components/composers/gridComposer/GridComposer.tsx", "TypeScript React", 237, 0, 0, 15, 252
"/Users/julianklummer/WebProjects/synergic/src/app/components/composers/gridComposer/gridCell/GridCell.tsx", "TypeScript React", 69, 0, 0, 7, 76
"/Users/julianklummer/WebProjects/synergic/src/app/components/composers/gridComposer/gridCell/gridCellChildren/GridCellChildren.tsx", "TypeScript React", 28, 0, 0, 3, 31
"/Users/julianklummer/WebProjects/synergic/src/app/components/composers/templateComposer/TemplateComposer.tsx", "TypeScript React", 19, 0, 0, 3, 22
"/Users/julianklummer/WebProjects/synergic/src/app/components/molecules/PageSettings/PageSettings.tsx", "TypeScript React", 232, 0, 0, 33, 265
"/Users/julianklummer/WebProjects/synergic/src/app/components/molecules/Sidebar/Sidebar.tsx", "TypeScript React", 17, 0, 0, 3, 20
"/Users/julianklummer/WebProjects/synergic/src/app/components/molecules/SidebarLeftSettings/SidebarLeftSettings.tsx", "TypeScript React", 63, 0, 0, 9, 72
"/Users/julianklummer/WebProjects/synergic/src/app/components/molecules/SidebarRightSettings/SidebarRightSettings.tsx", "TypeScript React", 126, 0, 0, 17, 143
"/Users/julianklummer/WebProjects/synergic/src/app/components/navbar/Navbar.tsx", "TypeScript React", 34, 0, 0, 6, 40
"/Users/julianklummer/WebProjects/synergic/src/app/contexts/CurrentEditedComponentContext.tsx", "TypeScript React", 26, 0, 0, 7, 33
"/Users/julianklummer/WebProjects/synergic/src/app/contexts/CurrentEditedGridCell.tsx", "TypeScript React", 31, 0, 0, 7, 38
"/Users/julianklummer/WebProjects/synergic/src/app/contexts/CurrentEditedPage.tsx", "TypeScript React", 23, 0, 0, 7, 30
"/Users/julianklummer/WebProjects/synergic/src/app/contexts/CurrentEditedTemplate.tsx", "TypeScript React", 26, 0, 0, 7, 33
"/Users/julianklummer/WebProjects/synergic/src/app/contexts/CurrentEditedTemplateComponent.tsx", "TypeScript React", 31, 0, 0, 7, 38
"/Users/julianklummer/WebProjects/synergic/src/app/index.tsx", "TypeScript React", 25, 0, 0, 2, 27
"/Users/julianklummer/WebProjects/synergic/src/app/pages/404/NoMatch.tsx", "TypeScript React", 4, 0, 0, 2, 6
"/Users/julianklummer/WebProjects/synergic/src/app/pages/componentCreator/ComponentCreator.tsx", "TypeScript React", 46, 0, 0, 2, 48
"/Users/julianklummer/WebProjects/synergic/src/app/pages/pageEditor/PageEditor.tsx", "TypeScript React", 34, 0, 0, 2, 36
"/Users/julianklummer/WebProjects/synergic/src/app/pages/start/Start.tsx", "TypeScript React", 27, 0, 0, 2, 29
"/Users/julianklummer/WebProjects/synergic/src/app/pages/templateEditor/TemplateEditor.tsx", "TypeScript React", 47, 0, 0, 2, 49
"/Users/julianklummer/WebProjects/synergic/src/app/router/Router.tsx", "TypeScript React", 20, 0, 0, 3, 23
"/Users/julianklummer/WebProjects/synergic/src/app/router/routes.tsx", "TypeScript React", 37, 0, 0, 4, 41
"/Users/julianklummer/WebProjects/synergic/src/app/services/builderApiUrl.tsx", "TypeScript React", 1, 0, 0, 0, 1
"/Users/julianklummer/WebProjects/synergic/src/app/services/contentApiUrl.tsx", "TypeScript React", 1, 0, 0, 0, 1
"/Users/julianklummer/WebProjects/synergic/src/app/services/fetchApi.tsx", "TypeScript React", 40, 0, 2, 8, 50
"/Users/julianklummer/WebProjects/synergic/src/app/styles/config/breakpoints.scss", "SCSS", 0, 11, 0, 1, 12
"/Users/julianklummer/WebProjects/synergic/src/app/styles/config/breakpoints.tsx", "TypeScript React", 11, 0, 0, 1, 12
"/Users/julianklummer/WebProjects/synergic/src/app/styles/config/colors.scss", "SCSS", 0, 25, 0, 6, 31
"/Users/julianklummer/WebProjects/synergic/src/app/styles/config/fonts.scss", "SCSS", 0, 17, 0, 3, 20
"/Users/julianklummer/WebProjects/synergic/src/app/styles/config/index.scss", "SCSS", 0, 5, 0, 0, 5
"/Users/julianklummer/WebProjects/synergic/src/app/styles/config/site-wrapper.scss", "SCSS", 0, 34, 0, 7, 41
"/Users/julianklummer/WebProjects/synergic/src/app/styles/config/transitions.scss", "SCSS", 0, 3, 0, 0, 3
"/Users/julianklummer/WebProjects/synergic/src/app/styles/functions/index.scss", "SCSS", 0, 2, 0, 1, 3
"/Users/julianklummer/WebProjects/synergic/src/app/styles/functions/media-query.scss", "SCSS", 0, 72, 0, 10, 82
"/Users/julianklummer/WebProjects/synergic/src/app/styles/functions/rem-convert.scss", "SCSS", 0, 8, 0, 2, 10
"/Users/julianklummer/WebProjects/synergic/src/app/styles/index.scss", "SCSS", 0, 3, 0, 1, 4
"/Users/julianklummer/WebProjects/synergic/src/app/styles/template/index.scss", "SCSS", 0, 1, 0, 1, 2
"/Users/julianklummer/WebProjects/synergic/src/app/styles/template/typography.scss", "SCSS", 0, 15, 0, 3, 18
"/Users/julianklummer/WebProjects/synergic/src/app/types/ComponentData.tsx", "TypeScript React", 17, 0, 0, 3, 20
"/Users/julianklummer/WebProjects/synergic/src/app/types/PageData.tsx", "TypeScript React", 22, 0, 0, 5, 27
"/Users/julianklummer/WebProjects/synergic/src/app/types/TemplateData.tsx", "TypeScript React", 11, 0, 0, 2, 13
"Total", "-", 2348, 196, 6, 316, 2866